BFFFFFFF
AFFFFFFF
AFFFFFFF
AD3FFFFF
C56FFFFF

0,0
0,1
S
